###############################################################################################################################
#                 |                 |                 |                 |                 |                 |                  
#                 |                 |                 |                 |                 |                 |                  
#                 |                 |                 |                 |                 |                 |                  
#                 |                 |                 |                 |                 |                 |                  
#                 |                 |                 |                 |                 |                 |                  
#                 |                 |                 |                 |                 |                 |                  
#                 |                 |                 |                 |                 |                 |                  
#                 |                 |                 |                 |                 |                 |                  
#                 |                 |                 |                 |                 |                 |                  
#-----------------+-----------------+-----------------+-----------------+-----------------+-----------------+----------------  
#                 |                 |                 |                 |                 |                 |                  
#                 |                 |                 |                 |                 |                 |                  
#                 |                 |                 |                 |                 |                 |                  
#                 |                 |                 |                 |                 |                 |                  
#                 |                 |                 |                 |                 |                 |                  
#                 |                 |                 |                 |                 |                 |                  
#                 |                 |                 |                 |                 |                 |                  
#                 |                 |                 |                 |                 |                 |                  
#                 |                 |                 |                 |                 |                 |                  
#-----------------+-----------------+-----------------+-----------------+-----------------+-----------------+----------------  
#                 |                 |                 |                 |                 |                 |                  
#                 |                 |                 |                 |                 |                 |                  
#                 |                 |                 |                 |                 |                 |                  
#                 |                 |                 |                 |                 |                 |                  
#                 |                 |                 |                 |                 |                 |                  
#                 |                 |                 |                 |                 |                 |                  
#                 |                 |                 |                 |                 |                 |                  
#                 |                 |                 |                 |                 |                 |                  
#                 |                 |                 |                 |                 |                 |                  
#-----------------+-----------------+-----------------+-----------------+-----------------+-----------------+----------------  
#                 |                 |                 |                 |                 |                 |                  
#                 |                 |                 |                 |                 |                 |                  
#                 |                 |                 |                 |                 |                 |                  
#                 |                 |                 |                 |                 |                 |                  
#                 |                 |                 |                 |                 |                 |                  
#                 |                 |                 |                 |                 |                 |                  
#                 |                 |                 |                 |                 |                 |                  
#                 |                 |                 |                 |                 |                 |                  
#                 |                 |                 |                 |                 |                 |                  
#-----------------+-----------------+-----------------+-----------------+-----------------+-----------------+----------------  
#                 |                 |                 |                 |                 |                 |                  
#                 |                 |                 |                 |                 |                 |                  
#                 |                 |                 |                 |                 |                 |                  
#                 |                 |                 |                 |                 |                 |                  
#                 |                 |                 |                 |                 |                 |                  
#                 |                 |                 |                 |                 |                 |                  
#                 |                 |                 |                 |                 |                 |                  
#                 |                 |                 |                 |                 |                 |                  
#                 |                 |                 |                 |                 |                 |                  
###############################################################################################################################