###############################################################################################################################
#                 |                 |                 |                 |                 |                 |                 #
#                 |                 |                 |                 |                 |                 |                 #
#                 |                 |                 |                 |                 |                 |                 #
#                 |                 |                 |                 |                 |                 |                 #
#                 |                 |                 |                 |                 |                 |                 #
#                 |                 |                 |                 |                 |                 |                 #
#                 |                 |                 |                 |                 |                 |                 #
#                 |                 |                 |                 |                 |                 |                 #
#-----------------+-----------------+-----------------+-----------------+-----------------+-----------------+-----------------#
#                 |                 |                 |                 |                 |                 |                 #
#                 |                 |                 |                 |                 |                 |                 #
#                 |                 |                 |                 |                 |                 |                 #
#                 |                 |                 |                 |                 |                 |                 #
#                 |                 |                 |                 |                 |                 |                 #
#                 |                 |                 |                 |                 |                 |                 #
#                 |                 |                 |                 |                 |                 |                 #
#                 |                 |                 |                 |                 |                 |                 #
#                 |                 |                 |                 |                 |                 |                 #
#-----------------+-----------------+-----------------+-----------------+-----------------+-----------------+-----------------#
#                 |                 |                 |                 |                 |                 |                 #
#                 |                 |                 |                 |                 |                 |                 #
#                 |                 |                 |                 |                 |                 |                 #
#                 |                 |                 |                 |                 |                 |                 #
#                 |                 |                 |                 |                 |                 |                 #
#                 |                 |                 |                 |                 |                 |                 #
#                 |                 |                 |                 |                 |                 |                 #
#                 |                 |                 |                 |                 |                 |                 #
#                 |                 |                 |                 |                 |                 |                 #
#-----------------+-----------------+-----------------+-----------------+-----------------+-----------------+-----------------#
#                 |                 |                 |                 |                 |                 |                 #
#                 |                 |                 |                 |                 |                 |                 #
#                 |                 |                 |                 |                 |                 |                 #
#                 |                 |                 |                 |                 |                 |                 #
#                 |                 |                 |                 |                 |                 |                 #
#                 |                 |                 |                 |                 |                 |                 #
#                 |                 |                 |                 |                 |                 |                 #
#                 |                 |                 |                 |                 |                 |                 #
#                 |                 |                 |                 |                 |                 |                 #
#-----------------+-----------------+-----------------+-----------------+-----------------+-----------------+-----------------#
#                 |                 |                 |                 |                 |                 |                 #
#                 |                 |                 |                 |                 |                 |                 #
#                 |                 |                 |                 |                 |                 |                 #
#                 |                 |                 |                 |                 |                 |                 #
#                 |                 |                 |                 |                 |                 |                 #
#                 |                 |                 |                 |                 |                 |                 #
#                 |                 |                 |                 |                 |                 |                 #
#                 |                 |                 |                 |                 |                 |                 #
#                 |                 |                 |                 |                 |                 |                 #
###############################################################################################################################